ATL: Atlanta Hawks
BKN: Brooklyn Nets
BOS: Boston Celtics
CHA: Charlotte Hornets
CHI: Chicago Bulls
CLE: Cleveland Cavaliers
DAL: Dallas Mavericks
DEN: Denver Nuggets
DET: Detroit Pistons
GSW: Golden State Warriors
HOU: Houston Rockets
IND: Indiana Pacers
LAC: Los Angeles Clippers
LAL: Los Angeles Lakers
MEM: Memphis Grizzlies
MIA: Miami Heat
MIL: Milwaukee Bucks
MIN: Minnesota Timberwolves
NJN: New Jersey Nets (sekarang Brooklyn Nets)
NOH: New Orleans Hornets (sekarang New Orleans Pelicans)
NOK: New Orleans/Oklahoma City Hornets (sementara selama bencana Katrina)
NOP: New Orleans Pelicans
NYK: New York Knicks
OKC: Oklahoma City Thunder
ORL: Orlando Magic
PHI: Philadelphia 76ers
PHX: Phoenix Suns
POR: Portland Trail Blazers
SAC: Sacramento Kings
SAS: San Antonio Spurs
SEA: Seattle SuperSonics (sekarang Oklahoma City Thunder)
TOR: Toronto Raptors
UTA: Utah Jazz
WAS: Washington Wizards